OBRIGATORIAS

HACA01	ESTUDOS SOBRE A CONTEMPORANEIDADE I 	
HACA09	CIÊNCIA E TECNOLOGIA I 	
LETE43	LÍNGUA PORTUGUESA, PODER E DIVERSIDADE CULTURAL 
HACA34	ESTUDOS SOBRE A CONTEMPORANEIDADE II 	
HACA38	CIÊNCIA E TECNOLOGIA II 	
LETE45	LEITURA E PRODUÇÃO DE TEXTOS EM LÍNGUA PORTUGUESA
HACA02	ELEMENTOS ACADÊMICOS E PROFISSIONAIS EM CIÊNCIA E TECNOLOGIA	

Grande Área
HACA39	CIÊNCIA E TECNOLOGIA III 	
HACA53	CIÊNCIA E TECNOLOGIA IV
HACB28	COMPUTAÇÃO APLICADA 	
HACA89	CONCEPÇÃO DE PRODUTOS TECNOLÓGICOS  
HACA88	DESENVOLVIMENTO DE PRODUTO E PRODUÇÃO INDUSTRIAL 
HACA93	DISPOSITIVOS TECNOLÓGICOS PRÁTICOS I 	
HACA94	DISPOSITIVOS TECNOLÓGICOS PRÁTICOS II 
HACA20		
HACA28		
HACA27		
HACB04	EMPREENDEDORISMO E INOVAÇÃO 
HACA99	FUNDAMENTOS DE BIOMATERIAIS E BIOTECNOLOGIA 	
HACA95	FUNDAMENTOS DE CIÊNCIAS DOS NOVOS MATERIAIS 	
HACB03	FUNDAMENTOS DE CRISTALOGRAFIA E DIFRAÇÃO DE RAIOS X 	
HACB27	FUNDAMENTOS DE ECOLOGIA E CIÊNCIAS AMBIENTAIS 	
HACA98	FUNDAMENTOS DE ENGENHARIA BIOMÉDICA E CLÍNICA 	
HACA97	FUNDAMENTOS DE ESPECTROSCOPIA 	
HACB01	FUNDAMENTOS DE MICROSCOPIA 	
HACA91	FUNDAMENTOS DE NANOCIÊNCIA E NANOTECNOLOGIA 
HACB02	GESTÃO DE PEQUENAS EMPRESAS DE BASE TECNOLÓGICA 	
HACA92	GESTÃO DE PROJETOS DE PESQUISA E DESENVOLVIMENTO 
HACA08	INTRODUÇÃO À NANOTECNOLOGIA
HACA96	LABORATÓRIO DE CIÊNCIA E TECNOLOGIA  
LETE46	Libras-Língua Brasileira de Sinais 
HACA83	MATEMÁTICA, NATUREZA E SOCIEDADE 
HACB39	METODOLOGIA DA PESQUISA 
HACA14
HACA90	SISTEMAS DE INOVAÇÃO EM CIÊNCIA E TECNOLOGIA 
HACA46	TOPICOS ESPECIAIS EM CIÊNCIAS I 	
HACB05	TÓPICOS ESPECIAIS EM CIÊNCIAS II  
HACA47	TÓPICOS ESPECIAIS EM TECNOLOGIA I 	
HACB06	TÓPICOS ESPECIAIS EM TECNOLOGIA II

Humanísticas
HACB78		
HACB76	ACC:AÇÕES INTERDISC... MORADORES DE RUA CENTRO HISTÓR - SSA 	
HACC16		
HACC17	
HACB16	ATELIÊ DO EMPREENDEDOR 	
HACA40	CAMPO DA SAÚDE: SABERES E PRÁTICAS 	
HACC02	CIDADE E NARRATIVAS GRÁFICAS 	
HACC18		
HACC07		
HACB90		
HACB89
HACC14	
HACC30		
HACC27		
HACC21		
HACC12		
HACB91		
HACC19		
HACC05	CULTURA E TURISMO
HACC09	CULTURAS BAIANAS 
HACC20		
HACC28			
HACC22
HACB82		
HACC23		
HACB33	ECONOMIA POLÍTICA INTERNACIONAL I 	
HACB95		
HACB99	ECONOMIA, TRABALHO E CIDADE 	
HACC06		
HACA20	
HACA76	ESTUDO DOS PODERES 	
HACA36	ESTUDOS DAS CULTURAS 	
HACA03	ESTUDOS DAS HUMANIDADES 
HACA35	ESTUDOS DAS SOCIEDADES 	
HACA77	ESTUDOS DAS SUBJETIVIDADES
HACB36	ESTUDOS DO CAPITALISMO 	
HACA51	ESTUDOS DO DESENVOLVIMENTO
HACB40	ESTUDOS SOBRE A INSTITUIÇÃO UNIVERSITÁRIA 
HACB32	HISTÓRIA DAS RELAÇÕES INTERNACIONAIS I 	
HACB26	INTRODUÇÃO À HISTÓRIA DAS CIÊNCIAS 
HACA10	INTRODUÇÃO AO CAMPO DA SAÚDE 
HACB15	MARKETING DE CIDADES 
HACB84	MEIO AMBIENTE, ENERGIA E CIDADE 
HACC08
HACB38	OFICINA DE TEXTOS EM HUMANIDADES
HACB31	ORGANIZAÇÕES E SOCIEDADES 	
HACB37	ORGANIZAÇÕES INTERNACIONAIS 	
HACC04	PATRIMÔNIO CULTURAL 	
HACB98	POLÍTICA E CIDADE 	
HACB35	POLÍTICA EXTERNA I 	
HACB93		
HACC25		
HACB30	POLÍTICAS PÚBLICAS 	
HACB22	POLÍTICAS PÚBLICAS, DIREITOS E CIDADE 	
HACC26
HACC24		
HACC31		
HACA50	RACIONALIDADES EM SAÚDE:SISTEMAS MÉDICOS E PRÁT.ALTERNATIVAS	
HACC01	REDES E CULTURAS URBANAS 	
HACB94		
HACA87	SAÚDE E CIDADE 	
HACB17	SAÚDE, EDUCAÇÃO E TRABALHO
HACB96	SEMINÁRIO DE PESQUISA 	
HACB62	SEMINÁRIO GESTÃO, FORMAÇÃO E VIDA UNIVERSITÁRIA 	
HACB63	SEMINÁRIO PROMOÇÃO DA SAÚDE E QUALIDADE DE VIDA 	
HACB64	SEMINÁRIO UNIVERSIDADE E SOCIEDADE 
HACC29	
HACB83
HACC10		
HACC15		
HACB34	TEORIA DAS RELAÇÕES INTERNACIONAIS I 	
HACB21	TEORIAS DA CIDADE E DO URBANO 	
HACB29	TEORIAS DA CULTURA 
HACA42	TOPICOS ESPECIAIS EM CULTURA I 	
HACB25	TÓPICOS ESPECIAIS EM ESTUDOS DAS CIDADES 
HACA43	TÓPICOS ESPECIAIS EM HUMANIDADES I 	
HACA52	TÓPICOS ESPECIAIS EM HUMANIDADES II 	
HACB18	TÓPICOS ESPECIAIS EM SAÚDE I 	
HACB19	TÓPICOS ESPECIAIS EM SAÚDE II 
HACC11		
HACC03	TRABALHO DE CONCLUSÃO DE CURSO EM ESTUDOS DAS CIDADES 	
HACB73	UNIVERSIDADE, CONVÍVIO SOCIAL E INTERCULTURALIDADES

Artísticas
HACA04	AÇÃO ARTÍSTICA I 	
HACA37	AÇÃO ARTÍSTICA II 	
HACA49	AÇÃO E MEDIAÇÃO CULTURAL ATRAVÉS DAS ARTES 
HACB07	ARQUEOLOGIA DAS ARTES E TECNOLOGIAS 	
HACB23	ARTE E CIDADE 	
HACA48	ARTE E ESTÉTICA 	
HACA82	ARTE E MATEMATICA 	
HACB11	ARTES E ELETRÔNICA 	
HACA07	ARTES E MUNDO DIGITAL 	
HACB24	ARTES E TRADIÇÕES POPULARES
HACB97	CIRCULAÇÃO, COMUNICAÇÃO E CIDADES 
HACC13 
HACB09	LABORATÓRIO DE ARTE INTERATIVA: ARTE E ELETRÔNICA 
HACB12	LABORATÓRIO DE ARTE INTERATIVA: ARTE E INTERFACES 
HACA44	LABORATÓRIOS DE CRIAÇÃO E PRÁTICAS ARTÍSTICAS 
HACB10	LINGUAGENS E AMBIENTES DE PROGRAMAÇÃO EM ARTES 
HACA45	OFICINAS DE INICIAÇÃO ARTÍSTICA 
HACA05	POLÍTICAS CULTURAIS 
HACB13	TÓPICOS ESPECIAIS EM ARTES E TECNOLOGIAS CONTEMPORÂNEAS 	
HACA79	TOPICOS ESPECIAIS EM ARTES I 	
HACA80	TOPICOS ESPECIAIS EM ARTES II 
HACB75	PRODUÇÃO E DIFUSÃO DO CONHECIMENTO EM ARTES 
HACB14	SISTEMAS DIGITAIS EM ARTES 
HACB08
HACA41
